11111111111111111
11100000000000001
1E110000010000001
10C1000P010010001
100100P00100100C1
11011110011000001
10C00C001111111C1
11111111111111111
