11111111111111111
11100000000000001
1C110000010000001
10C100001P0010001
100000000100100C1
11011110011000001
10C10C001111111C1
11111111111111111
